Real Date,Bank Date,Payer,Payee,Bank Message,Amount,Balance,Currency,Original data,Raw Real Date,Raw Bank Date,Raw Payer,Raw Payee,Raw Bank Message,Raw Amount,Raw Balance,Raw Currency
,2020-01-01,NAID-SE-SEK-40510020417,,Vardagspaket Månadspris kort,-24.00,8884.58,SEK,"{'Bokföringsdag': '2020-01-01', 'Belopp': -24.0, 'Avsändare': 'NAID-SE-SEK-40510020417', 'Mottagare': nan, 'Namn': nan, 'Rubrik': 'Vardagspaket Månadspris kort', 'Saldo': 8884.58, 'Valuta': 'SEK'}",,2020-01-01,NAID-SE-SEK-40510020417,,Vardagspaket Månadspris kort,-24.0,8884.58,SEK
,2019-12-30,NAID-SE-SEK-40510020417,,Kortköp 191226 Finnair AigkY6ET3,-213.00,8908.58,SEK,"{'Bokföringsdag': '2019-12-30', 'Belopp': -213.0, 'Avsändare': 'NAID-SE-SEK-40510020417', 'Mottagare': nan, 'Namn': nan, 'Rubrik': 'Kortköp 191226 Finnair AigkY6ET3', 'Saldo': 8908.58, 'Valuta': 'SEK'}",,2019-12-30,NAID-SE-SEK-40510020417,,Kortköp 191226 Finnair AigkY6ET3,-213.0,8908.58,SEK
,2019-12-30,NAID-SE-SEK-40510020417,,Betalning PG 4875503-7 Energikundse,-233.00,9121.58,SEK,"{'Bokföringsdag': '2019-12-30', 'Belopp': -233.0, 'Avsändare': 'NAID-SE-SEK-40510020417', 'Mottagare': nan, 'Namn': nan, 'Rubrik': 'Betalning PG 4875503-7 Energikundse', 'Saldo': 9121.58, 'Valuta': 'SEK'}",,2019-12-30,NAID-SE-SEK-40510020417,,Betalning PG 4875503-7 Energikundse,-233.0,9121.58,SEK
,2019-12-30,NAID-SE-SEK-40510020417,,Autogiro UNICEF,-100.00,9354.58,SEK,"{'Bokföringsdag': '2019-12-30', 'Belopp': -100.0, 'Avsändare': 'NAID-SE-SEK-40510020417', 'Mottagare': nan, 'Namn': nan, 'Rubrik': 'Autogiro UNICEF', 'Saldo': 9354.58, 'Valuta': 'SEK'}",,2019-12-30,NAID-SE-SEK-40510020417,,Autogiro UNICEF,-100.0,9354.58,SEK
,2019-12-30,NAID-SE-SEK-40510020417,,Autogiro FRIENDS,-100.00,9454.58,SEK,"{'Bokföringsdag': '2019-12-30', 'Belopp': -100.0, 'Avsändare': 'NAID-SE-SEK-40510020417', 'Mottagare': nan, 'Namn': nan, 'Rubrik': 'Autogiro FRIENDS', 'Saldo': 9454.58, 'Valuta': 'SEK'}",,2019-12-30,NAID-SE-SEK-40510020417,,Autogiro FRIENDS,-100.0,9454.58,SEK
,2019-12-30,NAID-SE-SEK-40510020417,,Autogiro LÄKARE UTAN,-50.00,9554.58,SEK,"{'Bokföringsdag': '2019-12-30', 'Belopp': -50.0, 'Avsändare': 'NAID-SE-SEK-40510020417', 'Mottagare': nan, 'Namn': nan, 'Rubrik': 'Autogiro LÄKARE UTAN', 'Saldo': 9554.58, 'Valuta': 'SEK'}",,2019-12-30,NAID-SE-SEK-40510020417,,Autogiro LÄKARE UTAN,-50.0,9554.58,SEK
