Bokföringsdag;Belopp;Avsändare;Mottagare;Namn;Rubrik;Saldo;Valuta
2020-01-01;-24,00;NAID-SE-SEK-40510020417;;;Vardagspaket Månadspris kort;8884,58;SEK
2019-12-30;-213,00;NAID-SE-SEK-40510020417;;;Kortköp 191226 Finnair AigkY6ET3;8908,58;SEK
2019-12-30;-233,00;NAID-SE-SEK-40510020417;;;Betalning PG 4875503-7 Energikundse;9121,58;SEK
2019-12-30;-100,00;NAID-SE-SEK-40510020417;;;Autogiro UNICEF;9354,58;SEK
2019-12-30;-100,00;NAID-SE-SEK-40510020417;;;Autogiro FRIENDS;9454,58;SEK
2019-12-30;-50,00;NAID-SE-SEK-40510020417;;;Autogiro LÄKARE UTAN;9554,58;SEK