Real Date,Bank Date,Payee,Bank Message,Amount,Balance,Original data,Raw Real Date,Raw Bank Date,Raw Payee,Raw Bank Message,Raw Amount,Raw Balance
,2019-09-01,Vardagspaket Månadspris kort,,-24.00,195689.01,"{'Datum': '2019-09-01', 'Transaktion': 'Vardagspaket Månadspris kort', 'Kategori': nan, 'Belopp': '-24,00', 'Saldo': '195.689,01'}",,2019-09-01,Vardagspaket Månadspris kort,,"-24,00","195.689,01"
,2019-08-30,Autogiro FRIENDS,,-100.00,195713.01,"{'Datum': '2019-08-30', 'Transaktion': 'Autogiro FRIENDS', 'Kategori': nan, 'Belopp': '-100,00', 'Saldo': '195.713,01'}",,2019-08-30,Autogiro FRIENDS,,"-100,00","195.713,01"
,2019-08-28,Betalning PG 4187500-6 Bank Norwegian,,-266.23,195813.01,"{'Datum': '2019-08-28', 'Transaktion': 'Betalning PG 4187500-6 Bank Norwegian', 'Kategori': nan, 'Belopp': '-266,23', 'Saldo': '195.813,01'}",,2019-08-28,Betalning PG 4187500-6 Bank Norwegian,,"-266,23","195.813,01"
,2019-08-28,Betalning PG 4875503-7 Energikundservi,,-314.00,196079.24,"{'Datum': '2019-08-28', 'Transaktion': 'Betalning PG 4875503-7 Energikundservi', 'Kategori': nan, 'Belopp': '-314,00', 'Saldo': '196.079,24'}",,2019-08-28,Betalning PG 4875503-7 Energikundservi,,"-314,00","196.079,24"
,2019-08-28,Autogiro UNICEF,,-100.00,196393.24,"{'Datum': '2019-08-28', 'Transaktion': 'Autogiro UNICEF', 'Kategori': nan, 'Belopp': '-100,00', 'Saldo': '196.393,24'}",,2019-08-28,Autogiro UNICEF,,"-100,00","196.393,24"
,2019-08-28,Autogiro LÄKARE UTAN,,-50.00,196493.24,"{'Datum': '2019-08-28', 'Transaktion': 'Autogiro LÄKARE UTAN', 'Kategori': nan, 'Belopp': '-50,00', 'Saldo': '196.493,24'}",,2019-08-28,Autogiro LÄKARE UTAN,,"-50,00","196.493,24"
